1)1 2 3 4 5 _

2)1 2 3 4 5
  _
  
3)1 2 3 4 5
  1 2 3 4 5
  
4)1 2 3 4 5
  1 2 3 4 5
  1 2 3 4 5
  1 2 3 4 5
  1 2 3 4 5
  
5)1 1 1 1 1
  2 2 2 2 2
  3 3 3 3 3
  4 4 4 4 4
  5 5 5 5 5